"filename", "language", "JSON", "TypeScript", "comment", "blank", "total"
"d:\faculta\AN3Sem2\Licenta\Licenta\package-lock.json", "JSON", 95, 0, 0, 0, 95
"d:\faculta\AN3Sem2\Licenta\Licenta\package.json", "JSON", 3, 0, 0, 0, 3
"d:\faculta\AN3Sem2\Licenta\Licenta\src\db\events.ts", "TypeScript", 0, 9, 0, 5, 14
"d:\faculta\AN3Sem2\Licenta\Licenta\src\db\plangeri.ts", "TypeScript", 0, 37, 0, 3, 40
"d:\faculta\AN3Sem2\Licenta\Licenta\src\db\users.ts", "TypeScript", 0, 8, 0, -4, 4
"d:\faculta\AN3Sem2\Licenta\Licenta\src\index.ts", "TypeScript", 0, 12, 0, 0, 12
"d:\faculta\AN3Sem2\Licenta\Licenta\src\routes\event-routes.ts", "TypeScript", 0, 117, 0, 16, 133
"d:\faculta\AN3Sem2\Licenta\Licenta\src\routes\plangeri-routes.ts", "TypeScript", 0, 129, 0, 18, 147
"d:\faculta\AN3Sem2\Licenta\Licenta\src\routes\request-routes.ts", "TypeScript", 0, -4, 0, 4, 0
"d:\faculta\AN3Sem2\Licenta\Licenta\src\util\constants.ts", "TypeScript", 0, 1, 0, 0, 1
"d:\faculta\AN3Sem2\Licenta\Licenta\src\util\methods.ts", "TypeScript", 0, 22, 0, 2, 24
"Total", "-", 98, 331, 0, 44, 473